{
  "mapName": "示例地图",
  "mapDescription": "这是一个测试用的示例地图",
  "mapWidth": 10,
  "cubeSize": 1.0,
  "rows": [
    { "row": [2, 1, 3, 0, 1, 2, 0, 1, 2, 1] },
    { "row": [1, 0, 2, 1, 0, 1, 2, 3, 1, 0] },
    { "row": [0, 1, 0, 2, 3, 2, 1, 0, 1, 2] },
    { "row": [1, 2, 3, 1, 0, 1, 0, 2, 1, 0] },
    { "row": [2, 0, 1, 0, 2, 3, 1, 0, 1, 2] },
    { "row": [1, 2, 0, 1, 0, 1, 2, 3, 0, 1] },
    { "row": [0, 1, 2, 3, 1, 0, 1, 0, 2, 1] },
    { "row": [3, 0, 1, 0, 2, 1, 0, 1, 3, 0] },
    { "row": [1, 2, 0, 1, 0, 2, 3, 1, 0, 1] },
    { "row": [2, 1, 3, 0, 1, 0, 1, 2, 1, 0] }
  ]
}
